00000000000000000000
00000000000000000000
00000000000000000000
00000000000000000000
00000111110000000000
00000152210000000000
00000122211111000000
00000123312141000000
00000123211141000000
00000111222241000000
00000011221221000000
00000012221111000000
00000012221000000000
00000011111000000000
00000000000000000000
00000000000000000000
00000000000000000000
00000000000000000000
00000000000000000000
00000000000000000000