00000000000000000000
00000000000000000000
00000000000000000000
00000000000000000000
00000000000000000000
00000000000000000000
00000001111000000000
00000011221000000000
00000015321000000000
00000011321100000000
00000011232100000000
00000014322100000000
00000014424100000000
00000011111100000000
00000000000000000000
00000000000000000000
00000000000000000000
00000000000000000000
00000000000000000000
00000000000000000000